cigo	авария (неудача)
mes 8 (mes bat)	августейший
australia	Австралия
bus	автобус
gar	автомобиль (повозка)
agres	агрессия
narak	ад
adres	адрес
asia	Азия
nitro	азот
bateri	аккумулятор
tcip	Албания
alkol	алкоголь
alah	Аллах
almas	алмаз
amerika	Америка (континент)
amper	ампер
analis	анализировать
nanas	ананас
englic	английский
anime	Анимация
anten	антенна
anus	анус
mes 4 (mes tcar)	апрель
dawa kan	аптека
arabi	арабский
bumi dou	арахис
arxentina	Аргентина
arena	Арена (стадион)
kira	аренда
armi	армия
asket	аскетический
aspirin	аспирин
asma	астма
atak	атака
atom	атом
afrika	Африка
a_	ах!
bagaj	багаж
baze	база (фундамент)
balkon	Балкон (веранда)
bambu	бамбук
banan	банан
bangla	Бангладеш; бенгальский
banka	банк
bar	Бар (паб)
tambur	барабан
basen	бассейн
fu	бах! (Тьфу!)
sapat	башмак
minara	башня
gubu	бегемот
bi no	без
sekur	безопасный
belarus	Беларусь
licu	белка
bai	белый
belgi	Бельгия
benzin	бензин
kosta	берег
beret	берет
beton	бетон
kitab kan	библиотека
biblia	библия
biznes	бизнес
biznes jen	бизнесмен
tiket	билет
jiva logi	Биология
visin	близлежащий (соседский)
dev	Бог
boikot	бойкотировать
bolgaria	Болгария
poto	болото
beng	больной
dai	большой
bomba	бомба
barda	борода
djang	Борьба (война)
tong	бочка (ведро)
brazil	Бразилия
gami	брак
aka	Брат или сестра
pantalon	брюки
buda	Будда
futur	будущее
kabau	буйвол
kara	буква (символ)
paper	бумага
tufan	буря
botol	бутылка
rapid	быстрый
e_	быть
budjet	бюджет
muhim	важный
hua bin	ваза
vaza	ваза
vaksin	вакцина
vanila	ваниль
banya	ванна
banya kamar	ванная
barbar	варвар
wat	ватт
wa	Вау!
inspira	вдохновлять
baldi	ведро
britan	Великобритания
madyar	Венгрия
venus	Венера
venesuela	Венесуэла
beranda	Веранда (крыльцо)
gamel	верблюд
cin	верить (вера)
pende	весить
fung	ветер
cam	вечер
festa	Вечеринка (фестиваль)
mater	вещество
ting	вещь
yang	Вид (стиль)
video	видео
vide	видеть
visa	виза
wiki	вики
forka	вилка
doc	вина
vinil	винил
vin	вино
putau	виноград
losi	винт
bunduk	винтовка
tcelo	виолончель
virus	вирус
virus logi	вирусология
vis	вице-
gusta	вкус
sultan	власть
na vis de	вместо
sui	вода
gida	водить машину
hawa	воздух
umur	возраст
bite lai in!	Войдите!
nami	волна
volta	вольт
eske	вопрос
bat	Восемь (8)
mum	воск
var 7 (var set)	Воскресенье
dong	восток
rong	Восточный дракон
djuca	впрыскивать
doktor	врач
mosim	время года
mei	все (каждый)
var 2 (var du)	вторник
yer	вчера
timen	вы
faida	выгода (польза, преимущество)
hisab	вычисление (арифметика)
viet	Вьетнам
gas	газ
gazel	газель
ayiti	Гаити
gayana	Гайана
galeri	галерея
hamak	гамак
ganga	Ганг
garanti	гарантия
harmoni	гармония
jele	Гель (желе)
hibride	Гибрид
himalia	Гималаи
gitar	гитара
sar	глава
mat	глаз
mitcin	глутамат натрия
mumu nama	говядина
nen	год
nen festa	годовщина
vos	голос
blu	голубой (синий)
nud	голый
can	Гора (холм)
gola	горло
hormon	гормон
laba	горн
siti	город
hotel	Гостиница
redi	готовый
gram	грамм
limit	граница
kenar	Граница (край)
helen	греческий
mogu	гриб
grimas	гримаса
grom	гром
mam	Грудь (сиськи)
grup	группа
pera	груша
lab	губа
guru	гуру (наставник)
ye	да
haide	Давай
dar	давать (дарить)
far	далеко
danmark	Дания
dant doktor	дантист
du	два (2)
mun	дверь (ворота, шлюз)
debat	дебаты
noi	Девять (9)
opa	Дед
mes 12 (mes des du)	Декабрь
kar	делать
demo krati	демократия
demon	демон
den	день (светлое время суток)
djen den	день рождения
pesa	Деньги
deya	деревня
mara	дерево
des	десять (10)
deci	деци-
djudo	дзюдо
sofa	диван
diske	диск
por	для
tal	дно
do	до
suba salam	Доброе утро
cam salam	Добрый вечер
den salam	Добрый день
doze	доза
vale	долина
dolar	доллар
bet	дом
dom	дом (домашний)
domino	домино
dau	дорога
pat	дорожка (путь)
paban	доска
bas	достаточно
drama	драма
kemet	Древний Египет (Кемет)
panyo	друг
alter	Другие
pensa	думать
bobo	Дурак (идиот)
anma	Дух (душа)
duc	душ
darma	дхарма (благочестие)
duman	дым
nafas	дыхание
catan	дьявол, чёрт
duna	дюна
andjil	евангелие
eurasia	Евразия
yehudi	еврей
euro	евро
europa	Европа
europa uni	Европейский Союз (ЕС)
misri	Египет
yem	есть
hai	еще
moli	жасмин
tren dau	железная дорога
fer	железо
wang	желтый
lulu	жемчуг
fem	женщина
jeste	жест
fubu	живот
hewan	животное
fet	жир
jiraf	жирафа
jiva	жить (жизнь)
abit	жить (обитать)
bul	забывать
san kan	завод
nale	завтра
suba yem	завтрак
kanun	закон
zambia	Замбия
tala	замок
parda	занавес
bizi	занят
weste	запад
koma	запятая
tuzi	заяц
tara	звезда
soni	звук
sismo	землетрясение
bumi	Земля (почва)
aina	зеркало
zimbabwe	Зимбабве
sap	знать
gim	золото
tcatar	зонтик
zarduc	Зороастр
zarduc din	зороастризм
dant	зуб
dant broc	зубная щетка
zulu	зулус
i_	и
ibri	иврит
pin	Игла
gem	игра
joga	Играть (веселиться)
idea	идея
go	идти
ze	из (от)
israel	Израиль
zumrud	изумруд
yesu	Иисус
u_	или
indji	имбирь
ha	иметь
imper	империя
nam	имя
barat	Индия
indonesia	Индонезия
tul	инструмент
tez	Интенсивный (в зависимости от контекста: сильный, бойкий, быстрый)
intervu	интервью
interes	интерес (интересный)
urdun	Иордания
irak	Ирак
sok	искать
arte	искусство
islam	ислам
island	Исландия
espanya	Испания
histori	история
italia	Италия
mes 7 (mes set)	июль
mes 6 (mes sis)	июнь
yaman	Йемен
yoga	йога
yod	йод
kabin	Кабина
ka	как
bi yang de	Как (в стиле)
ke yang?	как?
kakau	какао
kalsium	кальций
kambudia	Камбоджа
batu	камень
kamera	камера
kanada	Канада
kanal	канал
wadi	Каньон (ущелье)
kapitan	капитан
karaoke	караоке
kirat	карат
karate	каратэ
djeb	карман
kari	карри
karta	карта (карточка)
alu	картошка
kafe kan	кафе (кофейня)
gun	качество (атрибут, характеристика)
kaca	каша
kastan	каштан
karo	квадрат
kilo gram	кг
kenya	Кения
ketcap	кетчуп
kiwi	киви
it	кирпич
oksi	кислород
suan	кислый
djungok	Китай
putong han	Китайский (Путунхуа)
buton paban	клавиатура
klas	класс (категория)
kafas	клетка
sel	клетка (биология)
klub	клуб
cabi	ключ
buk	книга
boton	кнопка
kod	код (шифр)
pifu	кожа
koko	кокос
sosis	колбаса
janu	колено
tcakra	колесо
koloni	колония
kolun	колонна (столбец)
kolombia	Колумбия
tim	команда
moskit	комар
manga	комикс
mai	коммерция
kamar	комната (камера)
kompani	компания (корпорация)
komputer	компьютер
fin	конец
konus	конус
kandi	конфета (сладость)
kava	копать
kopi	копия
kuran	Коран
gen	корень
basket	корзина
brun	коричневый
kasa	коробка (ящик)
mumu	корова
duan	короткий
kosmos	космос
gut	кость
mau	кот (кошка)
kafe	кофе
kafe kop	кофейная чашка
sundar	красивый
ros	красный
krem	крем
krus	крест
kri	крик
piping	критика
bed	кровать
sang	кровь
minus	Кроме (минус)
wen	круг (колесо)
djara	кувшин
pupe	кукла
mais	кукуруза
kultur	культура
mai kap	купить
kupa	купол (свод)
kupon	купон (талон)
kok	курица
lava	лава
kamp	лагерь
laka	лак
lampa	лампа
lao	Лаос
gom	ластик
latvia	Латвия
singa	лев
dawa	Лекарство (медицина)
tep	лента
djangal	Лес (джунгли)
fei	летать
lubnan	Ливан
limun	лимон
limfa	лимфа
baca logi	лингвистика
huli	лиса
yep	лист
lietuva	Литва
liter	литр
muka	лицо
litci	личи
larva	личинка (гусеница)
bot	Лодка (судно)
uma	лошадь
luna	Луна
bibi	любимый
amor	любить
nas	люди
magi	магия
magnet	магнит
mes 5 (mes lim)	май
makedonia	Македония
malaisia	Малайзия
lit	маленький
boi	мальчик
malaria	малярия
mama	мама
mango	манго
mungus	мангуста
mangus	мангустин
migan	мандарин
manioka	маниока
mani	Мания (безумие)
maraton	марафон
margarin	маргарин
marsi	Марс
mes 3 (mes sam)	Март
marce	марш
maska	Маска (камуфляж)
makan	масло
cifu	Мастер (сенсей)
matras	матрас
matce	Матч (конкурс)
macin	машина
medalia	медальон (медаль)
baru	медведь
kuper	медь
mexiko	Мексика
melodi	мелодия
budan	Меркурий
mesi	Мессия (Христос)
lok	место
mes	месяц
metal	металл
metal nik	металлист
metod	метод
meter	метр
tunel tren	метро
sak	мешок (сумка)
mikro	микро-
mili	Милли-
giga	миллиард
mega	миллион (мега-)
kawai	милый (прекрасный, прелестный, кавайный)
badam	миндаль
kuang sui	минеральная вода
wazir kan	министерство
wai ting wazir kan	Министерство иностранных дел
wazir	министр
minut	минут
dunia	Мир
mit	миф
poli	много
gabar	могила (гробница)
model	Модель (дизайн)
nau	мозг
mi ge	мой
dua	молиться
jovan	молодой
milke	молоко
hamar	молоток
sat	момент
xan	Монарх (король, королева)
mongol	Монголия
monster	монстр
moral	Мораль (этика)
daria	Море (океан)
karot	морковь
hima rose	мороз
pul	мост
mos	мох
pica	моча
ken	мочь (быть способным к)
marmar	мрамор
sofi	мудрый
man	мужчина
musik	Музыка
ata	мука
muskul	мускул
ladji	мусор
zizi	муха
mimen	мы
sabun	мыло
wac	мыть
mucu	мышь
bama	Мьянма (Бирма)
mol	мягкий
nama	мясо
bola	мяч
na par	на (на поверхности)
nano	нано-
kontcung	насекомое
pompa	Насос
logi	наука
nasia	нация
asal	начало
kaici	начинать
sama	небо
nilon	нейлон
yo	некоторые
doitc	Немецкий
cau	Немного
zarura	Необходимый (критический)
nepal	Непал
neptun	Нептун
no	нет
naidjiria	Нигерия
nederland	Нидерланды
na cia	ниже (под)
nic	ниша
ama	но
xabar gazet	новины
xabar	Новости
nov	новый
naxun	ноготь
kati	нож
makas	ножницы
nul	ноль
numer	номер
norge	Норвегия
normal	норма (стандарт)
nos	нос
porta	Носить
corab	Носок (чулок)
faru	носорог
notce	ночь
mes 11 (mes des un)	ноябрь
nuton	Ньютон
waha	оазис
den yem	обед
komun	общий (взаимный)
putong	общий (обычный)
uni	объединять
meme	овца
fai	огонь
xiyar	огурец
fuk	одежда
un	Один (1)
o_	ой!
janela	окно
mes 10 (mes des)	октября
oman	Оман
ta	он или она
tamen	они
xatar	опасность
pei	оплата
orgazme	оргазм
ordu	орда
guang	освещение
iha	осёл
pulo	остров
akse	ось
dap	ответ
papa	отец
tcuti	отпуск
pak	пакет
paket	пакет
pakistan	Пакистан
xema	палатка
finger	палец
palma	Пальма
kot	пальто
yad	память
panda	панда
pandunia	Пандуния
panik	паника
papaya	папайя
paraguai	Парагвай
paskal	паскаль
djidju	паук
penis	пенис
numer un	Первый
piper	перец
zaman	период (эпоха)
puru	перо
farsi	Персидский (фарси)
peru	Перу
balu	песок
gana	петь
duka	печаль
biskut	печенье
gua	пещера
bir	пиво
piknik	пикник
ara	Пила
pilot	пилот
penguin	пингвин
mudan	пион
pirat	пират
kek	пирог (кекс)
pai	пирог (пирожное)
kitab	писать
leter	Письмо
pitsa	пицца
ron	плакать
plan	план
planet	планета
plastik	пластик
bad	Плохо (не хорошо)
xarab	Плохой (разрушенный)
maidan	площадь
pluto	Плутон
win	победа
tentci	Погода
detal	подробно
kusen	подушка
tren	поезд
asan	Поза (асана)
barka	поздравлять
viza	показать
poker	покер
kamar tal	пол
vide maidan	поле зрения
politik	политика
polis	полиция
banda	Полоса (повязка)
polska	Польша
tomat	помидор
var 1 (var un)	понедельник
aha	понимать
papagai	попугай
barud	порох
puder	порошок
kuli	Портер (куле)
portugal	Португалия
vizit	посещение(визит)
cam den	после полудня
bada	после, следующий
daici	посол
daici kan	посольство
posta	почта
zon	пояс (зона)
hak	право (привилегия)
teyan	предлагать
wakil	Представлять
cef wazir	премьер-министр
salam	привет
halo	Привет!
misal	пример
tabia	Природа
koz	причина
problem	проблема
program	программа
mai dar	продавать
projet	Проект
sade	простой
tcing	просьба
fan	Противостоящие (анти-)
peca	профессия
proses	процесс
paki	птица
puding	пудинг
xali	пустой
dul	пыли
var 5 (var lim)	пятница
lim	Пять (5)
gong	работа
gong jen	работник
gong kan	рабочее место
radio	радио
razon	разум
roket	ракета
ramazan	рамадан
rasa	раса
nabat	растение
rasti	расти
ban	ребёнок
bebe	ребенок новорожденный
daftar	регистр
lobak	редис
safar	рейс
nadi	река
din	религия
restoran	ресторан
reset	рецепт
roma	Рим
ris	рис
riske	риск
desen	рисунок
ritme	Ритм
rit	Ритуал (церемония)
korne	рог
djen	рождение
roza	Роза
rol	роль
rom	ром
rose	роса
boka	рот
rotor	ротор
kuang	руда
hat	рука
rola	рулон
rusi	русский
rusia	Россия
rutin	рутин
kalam	ручка
matci	рыба
bazar	Рынок (базар)
ruk sak	рюкзак
djin	рядом
gardin	сад
letis	салат
salada	салат
son kamar	сальня
se	сам
viman	самолет
sani	сани
cani	Сатурн
sukar	сахар
goro nama	свинина
goro	свинья
liber	Свободный
din guru	священник
sant	священный
nor	север
sismo logi	сейсмология
sir	секрет
seksi	Секс (половой акт)
sekun	секунд
selen	селен
camba	сельская местность
set	Семь (7)
famil	семья
dane	семя
mes 9 (mes noi)	сентябрь
serbia	Сербия
cim	сердце
net	сеть
sibir	Сибирь
sigar	сигара
sigaret	сигарета
sin	сигнал
bal	сильный
singapur	Сингапур
lilak	сирень
cirop	сироп
sistem	система
kata	сказка
banko	скамейка
sun	скоро
mat sui	слеза
slovenia	Словения
loga	слово
gadja	слон
audi	Слышать (слушать)
haha	смех
hima	снег
re	снова
waf	собака
konsel	Совет
guanci	Соединение (отношение)
uni stat de amerika	Соединенные Штаты Америки
jus	сок
xazin	сокровище (казна)
surya	солнце
sal	соль
son	сон
informa	сообщить
sporte	сорт
cup	сосать
sos	соус
lusun	спаржа
danke	спасибо
canti	спокойный
kabil	способный (компетентный)
var 3 (var sam)	среда
medi	средний
stadion	стадион
lau	Старый
makala	статья (документ)
mur	стена
wac macin	стиральная машина
cir	стих(поэма)
hon	сто
stop	стоп
gok	страна (государство, земля)
bizar	странный
fobi	страх (фобия)
libel	стрекоза
bana	строить
fila	строка
darsa ban	Студент (ученик)
kurse	стул
sabat	суббота
var 6 (var sis)	суббота
sudan	Судан
kismat	судьба
hakim guru	Судья (рефери)
hakim	Суждение
sanduk	сундук
sup	суп
suriname	Суринам
suxa	сухой
usa	США
tcis	сыр
tabak	табак
tabul	таблица (матрица)
taiga	тайга
tai	Тайский
plus	Также (плюс)
taksi	такси
taktik	Тактика (стратегия)
tanax	Танах
dans	танец
tanzania	Танзания
tatu	тату
badan	тело
tema	тема
oskur	темный
tenis	теннис
tcaya	тень
dev logi	теология
teori	теория
teror	террор
teste	Тест
tekni	техника
tekni logi	технология
tip	тип
tiran	тиран
titan	титан
tela	ткань (текстиль)
zira	тмин
sa far	то
yani	то есть
pang	Толстый (жирный)
sol	только
ton	тон
fain	тонкий (нежный)
tunel	тоннель
tabar	топор
dem	точка
presis	точный
gras	трава
sam	Три (3)
pipa	труба
tub	труба
tualet	туалет
tundra	тундра
tunis	Тунис
tur	Тур
turki	Турция
ti	ты
kilo	тысяча (кило-)
tulip	тюльпан
pagri	тюрбан
bandi kan	тюрьма
ging	уважение
yakin	уверенный
ai	Увы! (Ой!)
kona	угол
carbon	уголь
cok	Удар
darba	удар
ja	уже (в прошлом)
ukrayina	Украина
tsuka	уксус
budi	умный
madju	упряжь
hura	Ура (приветствие)
uran	Уран
uranium	уран
uruguai	Уругвай
amen	Утверждать (соглашаться, соглашаться, аминь)
suba	утро
or	ухо
darsa guru	учитель
darsa	учиться
famil nam	фамилия
fanat	фанатик
fantazi	фантазия (воображение)
fantom	фантом
dou	Фасоль или боб
mes 2 (mes du)	февраль
peri	фея
figur	фигура (представление)
fizik logi	физика
pilipin	Филиппины
filsofi	философия
filme	фильм
filter	фильтр
tamar	финик
suomi	Финляндия
bandera	Флаг (баннер)
fanus	фонарь
forma	форма
forum	Форум
fosfor	фосфор
foto	фотография
jumla	фраза
frans	Франция
pal	фрукт (результат)
funsi	функция
paunde	Фунт (£)
xalif	халиф
xaos	Хаос
dum	хвост
xerub	херувим
kimi	химическое вещество
kimi logi	химия
pan	хлеб
goton	хлопок
hobi	хобби
xolera	холера
xor	хор
horvat	Хорватия
bon	хорошо
okei	Хорошо
humus sos	хумус
hua	цветок
rang	цветок
gol	цель (намерение, задача)
sement	цемент
sensur	цензор
silsil	цепь (цепочка)
seres	Церера (карликовая планета)
eglis	церковь
zink	цинк
sitat	Цитата
tca	чай
tca wan	Чайная чаша
hor	час
fen	Часть (фракция)
tcat	Чат
wan	чаша
kop	чашка (стакан)
manuc	Человек
jen	человек (люди)
campion	чемпион
sar gut	череп
kal	чёрный
lasun	чеснок
var 4 (var tcar)	Четверг
tcar	Четыре (4)
tceska	Чешский
lat tcili	чили
tcile	Чили
saf	чистый
dok	читать
ke	что?
cakal	шакал
caman	шаман
cal	шарф
zafran	шафран
catur	шахматы
dama	шашки
svenska	Швеция
sis	Шесть (6)
cef	шеф (директор)
kuan	широкий
almari	шкаф
darsa kan	Школа (учреждение)
tcokolat	шоколад
lanka	Шри-Ланка
kelele	шум
jok	шутка
broc	щётка
ekuador	Эквадор
ekran	экран
lastik	эластичный
cik	Элегантный
eletre	электричество
eletron	электрон
energi	энергия
eris	Эрис (карликовая планета)
eritra	Эритрея
esti	Эстония
sa djin	это
sa	это или то
itiopia	Эфиопия
exo	эхо
jup	юбка
sud	юг
hanguk	Южная Корея
yumor	юмор
mucing	Юпитер
mi	я
pingo	яблоко
venen	яд
baca	язык
yak	як
batata	Ям
mes 1 (mes un)	январь
nipon	Япония
amuk	ярость
yasen	Ясень

